•                                                                                                   •
                        •                                   •                                        
                    •          •                                                             •     • 
                                                                                                     
                                                    •            •         •                 •       
                     •             •                       •                                         
                                                         •                      •                    
                     •                                                                               
                      •                                                       •                      
              •          •            •                                           •        •    •    
                                                                        •                     •      
                                                   •              •                                  
                                 •     •                                                             
                                  •                                                                  
                •                       •                                           •                
    •                                                                                                
                                                                                                     
                                                                 •                                   
                                                                                   •                 
                                                   •                                                 
                                                                                               •     
                                                                         •                           
                    •                •                                                               
          •                                                                                          
                                                                 •                          •        
                                  •                                                                  
                                                                                                     
                                                                                                     
   •                                                                                           •     
•                                                               •                      •             
                                                                      •         •                    
                                                                                                     
 •                                              •            •                                       
                                                      •                                              
                                                    • •               •                              
                                   •                   •                                             
                      •                                                 •                            
                           •                                                                    •    
                                                                                                     
  •                                                                                                  
                                                                                                     
             •                                                                                       
        •                                                                       •                    
                                                                                          •          
                                             •                       •                               
                                                   •                                      •          
       •                              •                                          •                   
             •                     •                •                                                
                                                                                                     
          •                                                                                          
                                            •                    •               •                   
                                        •                •                                       •   
                           •                  •                   •                                  
                                   •                                                                 
                                        •                                                            
             •                                •        •••••••••••••••••••••••••••••••               
                                  •                    •                             •               
                                                       •                             •               
                                                       •                             •               
                                                       •                             •               
                                                       •              •              •               
•                                                      •             •••             •               
        •                                              •            •••••            •               
           •                •                    •     •           •••••••           •               
           •                                           •          •••••••••          •    •          
                                             •         •            •••••            •               
                                                       •           •••••••           •               
                                                       •          •••••••••          •               
                    •                        •         •         •••••••••••         •               
                                                       •        •••••••••••••        •               
                                                       •          •••••••••          •               
                                                       •         •••••••••••         •               
                                                       •        •••••••••••••        •               
                                                       •       •••••••••••••••       •     •         
                                                       •      •••••••••••••••••      •              •
                                                       •        •••••••••••••        •               
                 •                                     •       •••••••••••••••       •    •          
                                        •              •      •••••••••••••••••      •               
                                                       •     •••••••••••••••••••     •    •          
                                                       •    •••••••••••••••••••••    •              •
                •              •                       •             •••             •               
                                              •        •             •••             •               
                   •                                   •             •••             •               
                                   •                   •                             •               
                                                       •                             •     •         
         • •                                           •                             •               
                    •                                  •                             • •             
                                                       •••••••••••••••••••••••••••••••               
  •                                                                                                  
                          •                                                                    •     
                                     •                            •   •                              
•                                                                                                    
                                                   •                                            •    
                                                        •                                            
                                                                                                     
                               •                                                                     
  •           • •                     •                                                              
                                            •                                                        
                                 •                                                                   
              •        •                                                                             
                      ••                                                                             
                                                                                                     
                                •                                                                    
